11111111111111111111111111111
100000000000000000000000M0001
10000MP0000000000000000000001
10000000001111111110000000001
1000000001000000E001000000001
10000000100001110000100000001
10000001CCCC11111CCCC10000001
10000000100001110000100000001
10000000010000000001000000001
10000000001111001110000000001
10M000000000000000000000M0001
11111111111111111111111111111